################################
#..............................#
#...........()...()............#
#...........\0---0/............#
#...........<_____>............#
#..............................#
#..............................#
#..............................#
#...(-)..................(-)...#
#...<\/.......(-)........\/>...#
#....\/.......\0/........\/....#
#...(0/.......<_>........\0)...#
#...<_>..................<_>...#
#..............................#
#..............................#
#..............................#
#...........(-----)............#
#...........\/___\/............#
#...........<>...<>............#
#..............................#
################################